###########################
#            #            #
# #### ##### # ##### #### #
# #  # #   # # #   # #  # #
# #### ##### # ##### #### #
#                         #
# #### ## ####### ## #### #
# #### ## ####### ## #### #
#      ##    #    ##      #
###### ##### # ##### ######
     # ##### # ##### #
     # ##         ## #
     # ## ####### ## #
###### ## #     # ## ######
#         #     #         #
###### ## ####### ## ######
     # ##         ## #
     # ## ####### ## #
     # ##         ## #
###### ## ####### ## ######
#            #            #
# #### ##### # ##### #### #
# #### ##### # ##### #### #
#   ##       P       ##   #
### ## ## ####### ## ## ###
### ## ## ####### ## ## ###
#      ##    #    ##      #
# ########## # ########## #
# ########## # ########## #
#                         #
###########################
