###########################
#............#............#
#.####.#####.#.#####.####.#
#.#  #.#   #.#.#   #.#  #.#
#.####.#####.#.#####.####.#
#.........................#
#.####.##.#######.##.####.#
#.####.##.#######.##.####.#
#......##....#....##......#
######.#####.#.#####.######
     #.#####.#.#####.#
     #.##         ##.#
     #.## ####### ##.#
######.## #     # ##.######
G........ #     # ........D
######.## ####### ##.######
     #.##         ##.#
     #.## ####### ##.#
     #.##.........##.#
######.## ####### ##.######
#............#............#
#.####.#####.#.#####.####.#
#.####.#####.#.#####.####.#
#...##.......P.......##...#
###.##.##.#######.##.##.###
###.##.##.#######.##.##.###
#......##....#....##......#
#.##########.#.##########.#
#.##########.#.##########.#
#.........................#
###########################
